11111111111111111
10002331303000001
10003034400131201
13002001020130301
12000201000201211
10040003030004031
11030021012313211
13010000200001201
11000201010001011
10040423000400001
12120131121101321
10332203230303021
10113104440102101
10000001010232001
11111111111111111