11111111111111111111116666666666666666661111111111111111111111111111
13330444444444444403316666666666666666661333004444444444444444003331
13000000000000000000316666666666666666661330000000000000000000000331
13000000000000000000011111111111111111111300000000000000000000000031
10000000000000000000000000003333333300000000000000000000000000000001
14000000000000000000000000000003400000000000000000000000000000000041
14000000000000000000000000000003400000000000000000000000000000000041
14000000004444400000000000000003400000000000000000000044444400000041
14000000004333300000000000000003400000000000000000000008888400000041
14000000004300000000000000000003400000000000000000000000008400000041
14000000004300000000000000000003400000000000000000000000008400000041
14000000000000000000000000000000000000000000000000000000000000000041
14000000000000000000000000000000000000000000000000000000000000000041
10000000000000000000000000000000000000000000000000000000000000000001
13000000000000000000000033333333333333300000000000000000000000000031
13000000000000000000000037777777777777300000000000000000000000000031
13000000000000000000000037777777777777300000000000000000000000000031
13000000000000000000000037777777777777300000000000000000000000000031
13000000000000000000000037777777777777300000000000000000000000000031
13000000000000000000000037777777777777300000000000000000000000000031
10000000000000000000000033333333333333300000000000000000000000000031
14000000000000000000000000000000000000000000000000000000000000000001
14000000000000000000000000000000000000000000000000000000000000000041
14000000000000000000000044444444444444400000000000000000000000000041
14000000000000000003333333333333333333333330000000000000000000000041
14000000000000000000000000003333330000000000000000000000000000000041
14000480000000000000000000000000000000000000000000000000000440000041
14000480000000000000000000000000000000000000000000000000003440000041
14000488880000000000000000000000000000000000000000000000033440000041
14000444440000000000000000000000000000000000000000000044444440000001
10000000000000000000000000000000000000000000000000000000000000000031
13000000000000000000000000000000000000000000000000000000000000000331
13300444444444444444444003333333333330044444444444444444444444003331
11111111111111111111111111111111111111111111111111111111111111111111